27
16
0 0 0 31 21 21 38 21 21 21 20 21 38 21 21 21 21 38 22 23 36 0 0 0 0 0 0 
0 0 0 30 1 2 3 2 3 2 2 2 2 2 3 2 3 3 3 4 37 0 0 0 0 0 0 
0 0 0 31 5 13 7 7 7 7 7 7 7 7 7 7 7 7 7 8 36 0 0 0 0 0 0 
0 0 0 32 9 11 11 11 10 11 10 10 7 7 7 7 7 7 14 8 36 0 0 0 0 0 0 
0 0 0 24 25 25 26 26 28 28 27 28 5 6 7 11 10 10 11 12 35 0 0 0 0 0 0 
0 0 0 0 0 0 0 0 0 0 0 32 5 7 8 25 25 25 25 25 29 0 0 0 0 0 0 
0 0 0 0 0 0 0 0 0 0 30 21 5 22 38 34 0 0 0 0 0 0 0 0 0 0 0 
0 0 0 0 0 0 0 0 0 0 30 1 7 2 13 34 0 0 0 0 0 0 0 0 0 0 0 
0 0 0 0 0 0 0 0 0 0 30 5 6 7 8 34 0 0 0 0 0 0 0 0 0 0 0 
0 0 0 0 0 0 0 0 0 0 30 9 10 11 12 34 0 0 0 0 0 0 0 0 0 0 0 
0 0 0 0 0 0 0 0 0 0 24 25 25 26 26 29 0 0 0 0 0 0 0 0 0 0 0 
0 0 0 0 0 0 0 0 0 0 0 0 0 0 0 0 0 0 0 0 0 0 0 0 0 0 0 
0 0 0 0 0 0 0 0 0 0 0 0 0 0 0 0 0 0 0 0 0 0 0 0 0 0 0 
0 0 0 0 0 0 0 0 0 0 0 0 0 0 0 0 0 0 0 0 0 0 0 0 0 0 0 
0 0 0 0 0 0 0 0 0 0 0 0 0 0 0 0 0 0 0 0 0 0 0 0 0 0 0 
0 0 0 0 0 0 0 0 0 0 0 0 0 0 0 0 0 0 0 0 0 0 0 0 0 0 0 
