32
11
0 0 0 0 0 0 0 0 0 0 0 0 0 0 0 0 0 0 0 0 0 0 0 0 0 0 0 0 0 0 0 26 
0 0 0 0 0 9 5 6 0 0 0 0 0 0 0 0 0 0 0 0 0 0 0 0 0 0 0 0 0 0 0 26 
0 0 0 0 0 20 21 22 0 0 0 0 0 0 0 0 0 0 0 0 0 0 0 0 0 0 0 0 0 0 0 26 
0 0 0 0 0 0 0 0 0 0 0 0 0 0 0 0 0 0 0 0 0 0 0 0 0 0 0 0 0 0 0 26 
0 0 0 0 0 0 0 0 0 0 0 0 0 0 0 0 0 0 0 0 0 0 0 0 0 0 0 0 0 0 0 26 
8 5 5 6 10 0 0 0 0 0 0 0 0 0 0 0 10 7 9 1 2 2 2 2 2 2 2 0 5 10 9 26 
24 24 24 24 25 0 0 0 0 0 0 0 0 0 0 23 24 24 24 32 33 33 33 33 33 33 23 24 24 24 24 4 
27 27 27 27 28 0 0 0 0 0 0 0 0 0 0 26 27 27 27 28 0 0 0 0 0 0 26 27 27 27 27 27 
27 27 27 27 28 0 0 0 0 0 0 8 5 10 0 26 27 27 27 28 0 0 0 0 0 0 26 27 27 27 27 27 
27 27 27 27 28 0 0 0 0 0 23 24 24 24 24 4 27 27 27 28 0 0 0 0 0 0 26 27 27 27 27 27 
27 27 27 27 28 0 0 0 0 0 26 27 27 27 27 27 27 27 27 28 0 0 0 0 0 0 26 27 27 27 27 27 
