38
27
31 21 21 21 21 21 21 21 21 21 21 21 21 21 21 21 21 21 21 21 21 21 21 21 21 21 21 21 21 21 21 21 21 21 21 21 21 34 
31 7 7 7 7 7 7 7 7 7 7 7 7 7 7 6 7 7 7 7 7 7 6 7 7 7 7 7 6 7 7 7 13 7 7 7 7 34 
31 7 7 14 7 6 7 7 7 7 6 7 7 7 7 7 7 7 7 7 7 7 7 6 7 7 7 7 7 7 7 7 7 7 7 7 7 34 
31 7 7 7 7 7 7 7 7 7 7 7 7 7 7 13 7 7 6 7 7 7 7 7 7 7 7 7 7 7 7 7 6 7 7 7 7 34 
31 7 7 7 7 7 23 23 7 7 7 7 21 38 21 21 21 38 21 21 21 38 21 21 21 38 21 7 6 23 23 7 7 7 6 7 7 34 
31 7 7 7 7 7 35 33 7 7 6 7 7 7 7 7 7 7 7 7 7 7 7 7 7 7 7 6 7 34 32 7 7 7 7 7 7 34 
31 7 6 7 7 7 35 33 7 7 7 7 7 7 7 7 7 7 7 7 7 7 7 7 7 7 7 7 7 34 32 7 7 7 7 7 7 34 
31 7 7 7 7 7 35 33 7 7 7 7 7 7 7 7 7 7 7 7 7 7 7 7 6 7 7 7 7 34 32 7 6 7 6 7 7 34 
31 7 7 7 7 7 35 33 7 7 7 7 7 6 7 7 7 7 7 7 7 7 7 7 7 6 7 7 7 34 32 7 7 7 7 7 7 34 
31 7 13 6 7 7 35 33 7 7 7 7 7 7 7 7 7 7 7 7 7 6 7 7 7 7 7 7 7 34 32 7 7 7 7 7 7 34 
31 7 7 7 7 7 35 33 7 7 7 6 7 7 7 7 7 6 7 7 7 7 6 7 7 7 7 7 7 34 32 7 7 6 7 6 7 34 
31 7 7 7 7 7 35 33 7 7 7 7 7 7 6 7 7 7 7 7 7 7 7 7 7 7 7 7 7 34 32 7 7 6 7 7 7 34 
31 7 7 7 7 7 35 33 7 7 7 7 7 7 7 7 7 6 7 7 7 7 7 7 7 7 7 7 7 34 32 7 7 6 7 7 7 34 
31 7 7 7 7 7 35 33 7 7 7 13 7 7 7 7 7 7 7 7 7 7 7 7 7 7 7 6 7 34 32 7 7 7 14 6 7 34 
31 7 7 7 7 7 35 33 7 7 7 7 7 6 7 7 7 7 7 6 7 7 6 7 7 7 7 7 7 34 32 7 7 7 7 7 7 34 
31 7 7 6 7 7 35 33 7 7 7 7 7 7 7 7 7 7 7 7 7 7 7 7 6 7 7 7 7 34 32 7 6 7 7 7 7 34 
31 7 7 7 7 7 35 33 7 7 7 7 6 7 7 7 7 7 6 7 7 7 7 7 7 7 7 13 7 34 32 7 6 6 14 6 7 34 
31 7 7 7 7 7 23 38 7 7 7 22 38 23 23 23 23 23 23 23 38 23 7 7 7 7 21 38 21 34 32 7 7 7 7 7 7 34 
31 7 7 7 7 7 7 7 7 7 7 7 7 7 7 7 7 34 33 7 7 7 7 7 7 7 7 7 7 23 23 7 7 7 6 7 7 34 
31 7 7 7 7 7 7 7 7 7 7 7 7 7 7 7 7 34 33 7 7 7 7 6 7 7 7 7 7 7 7 7 7 7 6 6 7 34 
31 7 7 6 7 7 7 7 7 7 7 7 7 7 7 7 7 34 33 7 7 7 7 7 7 7 7 7 7 7 7 7 7 7 7 7 7 34 
31 7 7 7 7 7 7 7 7 7 7 7 6 7 7 7 7 34 33 7 7 7 7 7 7 7 7 6 7 7 7 7 7 7 7 6 7 34 
31 7 7 7 7 6 7 7 7 6 7 7 7 7 7 7 7 38 22 7 7 7 7 6 7 7 7 7 7 7 7 7 6 7 7 7 7 34 
31 7 7 7 7 7 7 7 7 7 7 7 7 6 7 7 7 7 7 7 7 7 7 7 7 7 7 7 7 7 6 7 7 7 13 7 7 34 
31 7 7 7 7 7 7 7 7 7 7 7 7 7 7 7 7 6 7 7 6 7 7 7 7 7 6 7 7 7 7 7 7 6 6 7 7 34 
31 7 7 14 7 7 7 7 7 7 7 7 7 7 6 7 7 7 7 7 7 7 7 7 7 7 7 7 7 7 7 7 7 7 7 7 7 34 
28 28 28 28 28 28 28 28 28 28 27 28 28 28 26 28 28 28 28 26 28 28 28 28 28 26 28 28 28 28 28 28 28 28 26 28 28 28 
