93
22
0 0 0 0 0 0 0 0 0 0 0 0 0 0 0 0 0 0 0 0 0 0 0 0 0 0 0 0 0 0 0 0 0 0 0 0 0 0 0 0 0 0 0 0 0 0 0 0 0 0 0 0 0 0 0 0 0 0 0 0 0 0 0 0 0 0 0 0 0 0 0 0 0 0 0 0 0 0 0 0 0 0 0 0 0 0 0 0 0 0 0 0 33 
0 0 0 0 0 0 0 0 0 0 0 0 0 0 0 0 0 0 0 0 0 0 0 0 0 0 0 0 0 0 0 0 0 0 0 0 0 0 0 0 0 0 0 0 0 0 0 0 0 0 0 0 0 0 0 0 0 0 0 0 0 0 0 0 0 0 0 0 0 0 0 0 0 0 0 0 0 0 0 0 0 0 0 0 0 0 0 0 0 0 0 30 46 
0 0 0 0 0 0 0 0 0 0 0 0 0 0 0 0 0 0 0 0 0 0 1 3 0 0 0 0 0 0 0 0 0 0 0 0 0 0 0 0 0 0 0 0 0 0 0 0 0 0 0 0 0 0 0 0 0 0 0 0 0 0 0 0 0 0 0 0 0 0 0 0 0 0 0 0 0 0 0 0 0 0 0 0 0 0 0 0 0 0 0 33 34 
0 1 3 0 0 0 0 0 0 0 0 0 0 0 0 0 0 0 0 0 0 0 48 49 49 49 49 50 0 0 0 0 0 0 0 0 0 0 0 0 0 0 0 0 0 0 0 0 0 0 0 0 0 0 0 0 0 0 0 0 0 0 0 0 0 0 0 0 0 0 0 0 0 0 0 0 0 0 0 0 0 0 0 0 0 0 0 0 0 0 0 36 41 
49 49 49 49 49 49 50 0 0 0 0 0 0 0 0 0 0 0 0 0 0 0 33 45 34 34 34 51 50 0 0 0 0 0 0 0 0 0 0 0 0 0 0 0 0 0 0 0 0 0 0 0 0 0 0 0 0 0 0 0 0 0 0 0 0 0 0 0 0 0 0 0 1 3 0 0 0 0 0 0 0 0 0 0 0 0 0 0 0 0 0 0 33 
34 34 45 34 34 34 43 31 32 0 0 0 0 0 0 0 0 0 0 0 0 48 46 34 34 45 34 45 35 0 0 0 0 0 0 0 0 0 0 0 0 0 0 0 0 0 0 0 0 0 0 0 0 0 0 0 0 0 0 0 0 0 0 0 0 0 0 0 0 0 0 0 48 49 50 0 0 0 0 0 0 0 0 0 0 0 0 0 0 0 0 0 33 
34 34 34 34 34 45 34 40 38 0 0 0 0 0 0 0 0 0 0 0 0 36 37 37 41 40 37 37 38 0 0 0 0 0 0 0 0 0 0 0 0 0 0 0 0 0 0 0 0 0 0 0 0 0 0 0 0 0 0 0 0 0 0 0 0 0 0 0 1 3 48 49 49 49 49 50 0 0 0 0 0 0 0 0 4 0 0 0 0 0 0 0 33 
34 34 34 34 34 34 34 35 0 0 0 0 0 0 0 0 0 0 0 0 0 0 0 0 36 38 0 0 0 0 0 0 0 0 0 0 0 0 0 0 0 0 0 0 0 0 0 0 0 0 0 0 0 0 0 0 0 0 0 0 0 0 0 0 0 0 0 0 48 49 49 49 49 49 49 49 50 0 0 0 0 0 0 30 31 32 0 0 0 0 30 31 46 
34 34 34 34 40 37 37 38 0 0 0 0 0 0 0 0 0 0 0 0 0 0 0 0 0 0 0 0 0 0 0 0 0 0 0 0 0 0 0 0 0 0 0 0 0 0 0 0 0 0 0 0 0 0 0 0 0 0 0 0 0 0 0 0 0 0 0 0 33 34 34 34 34 34 34 40 38 0 0 0 0 0 0 36 37 38 0 0 0 0 33 34 34 
34 34 34 40 38 0 0 0 0 0 0 0 0 0 0 0 0 0 0 0 0 0 0 0 0 0 0 0 0 0 0 0 0 0 0 0 0 0 0 0 0 0 0 0 0 0 0 0 0 0 0 0 0 0 0 0 0 0 0 0 0 0 0 30 31 32 0 0 36 37 37 41 34 34 34 35 0 30 31 32 0 0 0 0 0 0 0 0 0 0 33 34 34 
34 34 34 35 0 0 0 0 0 0 0 0 0 0 0 0 0 0 0 0 0 0 0 0 0 0 0 0 0 0 0 0 0 0 0 0 0 0 0 0 0 0 0 0 0 0 0 0 0 0 0 0 0 0 0 0 0 0 0 0 0 0 0 33 42 35 0 0 0 0 0 36 37 41 40 38 0 36 41 35 0 0 0 0 0 0 0 0 0 30 46 34 34 
34 34 34 35 0 0 0 0 0 0 0 0 0 0 0 0 0 0 0 0 0 0 0 0 0 0 0 0 0 0 0 0 0 0 0 0 0 0 0 0 0 0 0 0 0 0 0 0 0 0 0 0 0 0 0 0 0 0 0 0 0 0 0 33 40 38 0 0 0 0 0 0 0 36 38 0 0 0 36 38 0 0 0 0 0 0 0 0 0 36 41 34 34 
34 42 34 35 0 0 0 0 0 0 0 0 0 0 0 0 0 0 0 0 0 0 0 0 0 0 0 0 0 0 0 0 0 0 0 0 0 0 0 0 0 0 0 0 0 0 0 0 0 0 0 0 0 0 0 0 0 0 0 0 0 0 0 36 38 0 0 0 0 0 0 0 0 0 0 0 0 0 0 0 0 0 0 0 0 0 0 0 0 0 33 34 34 
34 34 34 35 0 0 0 0 0 0 0 0 0 0 0 0 0 0 0 0 0 0 0 0 0 0 0 0 0 0 0 0 0 0 0 0 0 0 0 0 0 0 0 0 0 0 0 0 0 0 0 0 0 0 0 0 0 0 0 0 0 0 0 0 0 0 0 0 0 0 0 0 0 0 0 0 0 0 0 0 0 0 0 0 48 49 49 49 49 49 46 34 34 
34 34 34 43 31 31 32 0 0 0 0 0 8 0 4 5 6 7 0 0 0 0 0 9 0 0 0 0 0 0 0 0 0 0 0 0 0 0 4 6 6 6 6 6 6 7 0 0 0 0 0 0 0 0 0 0 0 0 0 0 0 0 0 0 0 0 0 0 0 0 0 0 0 0 0 0 0 0 0 0 0 0 0 0 33 34 34 34 34 34 34 34 34 
34 34 34 34 34 34 51 49 49 49 49 49 49 52 52 52 52 52 52 52 52 52 52 49 49 49 49 50 0 0 0 0 0 0 0 0 48 49 49 49 49 49 49 49 49 49 49 49 49 49 49 49 50 0 0 0 0 0 0 0 0 0 0 0 0 0 0 0 0 0 0 0 0 0 0 0 0 0 0 0 0 0 0 0 33 34 34 34 34 34 34 34 34 
34 34 34 34 34 34 45 34 34 34 34 34 35 0 0 0 0 0 0 0 0 0 48 49 49 49 49 49 50 0 1 2 3 0 4 7 33 45 34 34 34 34 34 34 34 34 34 34 34 34 34 51 49 49 49 49 50 0 0 1 2 3 0 0 0 0 1 3 0 0 0 0 0 0 0 0 0 0 0 0 0 0 48 49 46 34 34 34 34 34 34 34 34 
34 34 34 34 34 34 34 34 34 34 34 40 38 0 0 0 0 0 0 0 0 0 36 41 42 45 34 34 51 49 49 49 49 49 49 49 46 34 34 34 34 34 34 34 34 34 34 34 34 34 34 34 51 49 49 49 49 49 49 49 49 49 49 49 52 52 52 52 52 52 52 49 49 49 49 49 50 0 0 0 0 0 33 34 34 34 34 34 34 34 34 34 34 
34 42 34 34 34 34 34 34 45 34 34 35 0 0 0 0 0 0 0 0 0 0 0 33 34 34 34 34 34 34 34 45 34 34 34 34 34 34 34 34 34 34 34 34 34 34 34 34 34 34 34 34 34 34 34 34 34 34 34 34 34 34 34 35 0 0 0 0 0 0 0 33 34 34 34 51 49 49 49 49 49 49 46 34 34 34 34 34 34 34 34 34 34 
34 34 34 34 34 34 34 34 34 34 34 35 0 0 0 0 0 0 0 0 0 0 0 33 34 34 34 34 34 34 34 34 34 34 34 34 34 34 34 34 34 34 45 34 34 34 34 34 34 34 34 34 34 34 34 34 34 34 34 34 34 34 40 38 0 0 0 0 0 0 0 36 41 34 34 34 34 34 34 34 34 34 34 34 34 34 34 34 34 34 34 34 34 
34 34 34 34 34 42 34 34 34 34 34 35 1 3 0 0 0 0 0 0 1 2 3 33 34 42 34 34 34 34 34 34 34 34 34 34 34 34 34 34 34 34 34 34 34 34 42 34 34 34 34 34 34 34 34 34 34 34 34 34 34 34 35 0 0 0 0 0 0 0 0 0 33 34 34 34 34 34 34 34 34 34 34 34 34 34 34 34 34 34 34 34 34 
34 34 34 34 34 34 34 34 34 34 45 43 44 52 52 52 52 52 52 52 52 52 39 46 34 34 34 34 34 45 34 34 34 34 34 34 42 34 34 34 34 34 34 34 34 34 34 34 34 34 34 34 34 34 34 34 34 34 34 34 34 34 35 0 0 0 0 0 0 0 0 0 33 34 34 34 34 34 34 34 34 34 34 34 34 34 34 34 34 34 34 34 34 
